{
	"numX": 13,
	"numY": 9,
	"size": [64, 64],
	"start": [32, 32],
	"tileNames":["", "ProtoCoin", "ProtoBox", "Tile01", "ProtoBat"],
	"tiles":[0, 0, 0, 0, 1, 0, 0, 0, 1, 0, 0, 0, 0,
			 0, 0, 0, 1, 0, 1, 0, 1, 0, 1, 0, 0, 0,
			 0, 0, 4, 0, 0, 0, 0, 0, 0, 0, 4, 0, 0,
			 0, 0, 3, 0, 0, 3, 0, 3, 0, 0, 3, 0, 0,
			 4, 0, 0, 0, 0, 0, 1, 0, 0, 0, 0, 0, 4,
			 3, 0, 1, 0, 0, 1, 0, 1, 0, 0, 1, 0, 3,
			 0, 3, 0, 1, 1, 0, 0, 0, 1, 1, 0, 3, 0,
			 0, 2, 0, 0, 0, 0, 0, 0, 0, 0, 0, 2, 0,
			 3, 3, 3, 3, 3, 3, 3, 3, 3, 3, 3, 3, 3
	]
}